20x20
XXXXXXXXXXXXXXXXXXXX
XXX..............XXX
XX.....      .....XX
X...            ...X
X..              ..X
X..              ..X
X..     ....     ..X you can even type comments
X.     ..XX..     .X outside the 20x20 perimeter
X.    ..XXXX..    .X
X.    .XXXXXX.    .X
X.====.XXXXXX.    .X
X.    ..XXXX..    .X
X.     ..XX..     .X
X..     ....     ..X
X..              ..X
X..              ..X
X...            ...X
XX.....      .....XX
XXX..............XXX
XXXXXXXXXXXXXXXXXXXX