20x40
XXXXXXXXXXXXXXXXXXXX
XXX..............XXX
XXX.....    .....XXX
XX.....      .....XX
XX....        ....XX
X....          ....X
X....          ....X
X...            ...X
X...            ...X
X...            ...X
X..              ..X
X..              ..X
X..      ..      ..X
X.      ....      .X
X.      .XX.      .X
X.     ..XX..     .X
X.     .XXXX.     .X
X.    ..XXXX..    .X
X.    .XXXXXX.    .X
X.    .XXXXXX.    .X
X.====.XXXXXX.    .X
X.    .XXXXXX.    .X
X.    ..XXXX..    .X
X.     .XXXX.     .X
X.     ..XX..     .X
X.      .XX.      .X
X.      ....      .X
X..      ..      ..X
X..              ..X
X..              ..X
X...            ...X
X...            ...X
X...            ...X
X....          ....X
X....          ....X
XX....        ....XX
XX.....      .....XX
XXX.....    .....XXX
XXX..............XXX
XXXXXXXXXXXXXXXXXXXX